R 1024 720
NO ./textures/greystone.xpm
SO ./textures/redbrick.xpm
WE ./textures/purplestone.xpm
EA ./textures/wood.xpm

S ./textures/barrel.xpm
F 220,100,0
C 225,30,0
        1111111111111111111111111
        1000000000110000000000001
        1011000001110000000000001
        1001020000000000000200001
111111111011000001110000000000001
100000000011000001110111111111111
11110111111111011100000010001
11110111111111011101010010201
11000000110101011100000010201
10000000000002001100000010001
1000000000S000001101010000001
1100000111010101111101110000111
11110111 1110101 101111010001
11111111 1111111 111111111111
